1,1,1,1,1,1,1,1,1,1,1,1,1,1,1,1,1,1,1,1
1,1,1,1,1,1,1,1,1,1,1,1,1,1,1,1,1,1,1,1
1,1,1,1,1,1,1,1,1,1,1,1,1,1,1,1,1,1,1,1
1,1,1,1,1,1,1,1,1,1,1,1,1,1,1,1,1,1,1,1
1,1,1,1,1,1,1,1,1,1,1,1,1,1,1,1,1,1,1,1
1,1,1,1,1,1,1,1,1,1,1,1,1,1,1,1,1,1,1,1
0,0,0,0,0,1,0,1,0,0,0,1,1,1,1,1,0,1,0,0
0,0,0,0,0,1,0,0,0,0,0,0,0,0,0,1,0,1,0,0
0,0,0,0,0,1,0,z,0,1,0,c,0,1,0,1,0,1,0,0
0,0,0,0,0,0,0,1,0,1,1,1,1,1,0,1,0,0,0,0
0,0,0,0,0,0,0,1,0,0,0,1,0,1,0,1,0,0,0,0
0,0,0,0,0,1,0,1,0,0,0,1,0,1,0,0,0,1,0,0
0,0,0,0,0,1,1,1,3,x,0,0,0,1,0,0,1,1,2,0
1,1,1,1,1,1,1,1,1,1,1,1,1,1,1,1,1,1,1,1
a,A,b,B,0,0,0,0,0,0,0,0,0,0,0,0,0,0,0,0
1
现在你有了新的能力，试试按下space键
再次按下space键试试
注意左下角的使用次数\n每关都有限定的使用的次数