1,1,1,1,1,1,1,1,1,1,1,1,1,1,1,1,1,1,1,1
0,0,0,0,r,a,l,1,1,1,A,1,0,0,B,0,0,1,0,2
0,0,0,l,0,r,v,1,0,1,0,1,0,0,0,0,0,1,0,0
1,1,1,1,u,1,1,1,0,1,0,1,0,4,0,4,0,1,1,u
0,0,r,0,0,0,0,1,0,l,0,1,0,0,0,0,0,1,0,0
u,1,1,1,1,1,1,1,0,1,1,1,4,0,c,0,4,1,u,1
0,0,0,0,0,0,0,1,0,1,1,1,0,0,1,0,0,1,0,0
1,1,1,1,0,0,0,1,0,1,0,0,0,0,0,0,0,1,1,u
1,1,1,1,d,1,0,1,0,1,0,4,0,4,0,4,0,1,0,0
1,1,0,0,b,1,u,1,0,1,0,0,0,0,0,0,0,1,u,1
0,0,0,0,0,r,0,l,0,1,4,0,4,0,4,0,4,1,0,0
0,0,1,d,1,1,1,1,0,1,0,0,0,0,0,0,0,1,1,u
0,z,1,x,0,0,0,1,3,1,0,4,0,4,0,4,0,0,0,0
1,1,1,1,1,1,1,1,1,1,1,1,1,1,1,1,1,1,1,1
0,0,0,0,0,0,0,0,0,0,0,0,0,0,0,0,0,0,0,0
0
这关不许使用技能
单向通道只允许从一个方向通过\所以gg~~,重开吧
带尖刺的东西是不允许接触的
有些人还活着^v^