1,1,1,1,1,1,1,1,1,1,1,1,1,1,1,1,1,1,1,1
0,0,0,0,0,0,0,0,0,1,A,0,0,0,4,0,1,0,0,0
0,0,0,0,0,0,0,0,0,1,0,0,0,0,0,0,r,0,0,0
0,0,0,0,0,0,0,0,0,1,0,0,0,0,4,0,1,0,5,0
0,0,0,0,0,0,0,0,0,1,1,u,u,u,u,u,u,u,1,1
0,0,0,0,0,0,0,0,0,1,0,0,4,0,4,0,4,0,0,0
0,0,0,0,0,0,0,0,0,1,0,0,0,0,0,0,0,0,0,0
0,0,0,0,0,0,0,a,0,1,5,0,4,0,4,0,4,0,0,0
1,1,1,1,1,1,1,1,u,1,1,d,d,d,d,d,d,d,1,1
1,1,1,1,1,1,1,1,0,1,0,0,0,0,0,0,0,0,0,0
1,1,1,1,0,5,0,1,0,1,0,0,0,0,0,0,1,0,0,0
1,1,1,1,u,1,u,1,u,1,0,0,1,0,0,0,1,0,0,0
0,z,5,l,5,1,0,5,0,1,0,0,1,0,2,0,1,0,3,0
1,1,1,1,1,1,1,1,1,1,1,1,1,1,1,1,1,1,1,1
b,B,0,0,0,0,0,0,0,0,0,0,0,0,0,0,0,0,0,0
1
在开关上按下J键



